1111000111111000111110-
1110000111110000110000-
0000000011100000000000-
0000000000000000000000-
0001110000000001111000-
0011111100000011111000-
0001111110000111110000-
0000111110000111000001-
0000000000000000000011-
1110000000000000000100